1111111111111111111111111111111111111111111111111111111111111111111111111111111
1111111111111111111111111111111111111111111111111111111111111111111111111111111
1100000000000000000000000000100000000000000000000000000000000000000000000000011
1100000000000000000000000001000000000000000000000000000000000000000000000000011
1100000000000000000000000010000000000000000000000000000000000000000000000000011
1100000000000000000000000100000000000000000000000000000000000000000000000000011
1100000000000000000000001000000000000000000000000000000000000000000000000000011
1100000000000000000000010000000000000000000000000000000000000000000000000000011
1100000000000000000000100000000000000000000000000000000000000000000000000000011
1100000000000000000001000000000000000000000000000000000000000000000000000000011
1100000000000000000010000000000000000000000000000000000000000000000000000000011
1100000000000000000100000000000000000000000000000000000000000000000000000000011
1100000000000000001000000000000000000000000000000000000000000000000000000000011
1100000000000000010000000000000000000000000000000000000000000000000000000000011
1100000000000000100000000000000000000000000000000000000000000000000000000000011
1100000000000001000000000000000000000000000000000000000000000000000000000000011
1100000000000010000000000000000000000000000000000000000000000000000000000000011
1100000000000100000000000000000000000000000000000000000000000000000000000000011
1100000000001000000000000000000000000000000000000000000000000000000000000000011
1100000000010000000000000000000000000000000000000000000000000000000000000000011
1100000000100000000000000000000000000000000000000000000000000000000000000000011
1100000001000000000000000000000000000000000000000000000000000000000000000000011
1100000010000000000000000000000000000000000000000000000000000000000000000000011
1100000100000000000000000000000000000000000000000000000000000000000000000000011
1100001000000000000000000000000000000000000000000000000000000000000000000000011
1100010000000000000000000000000000000000000000000000000000000000000000000000011
1120100000000000000000000000000000000000000000000000000000000000000000000000011
1110000000000000000000000000000000000000000000000000000000000000000000000000011
1101000000000000000000000000000000000000000000000000000000000000000000000000011
1100100000000000000000000000000000000000000000000000000000000000000000000000011
1100010000000000000000000000000000000000000000000000000000000000000000000000011
1100001000000000000000000000000000000000000000000000000000000000000000000000011
1100000100000000000000000000000000000000000000000000000000000000000000000000011
1100000010000000000000000000000000000000000000000000000000000000000000000000011
1100000001000000000000000000000000000000000000000000000000000000000000000000011
1111111111100000000000000000000000000000000000000000000000000000000000000000011
1100000000010000000000000000000000000000000000000000000000000000000000000000011
1100000000001000000000000000000000000000000000000000000000000000000000000000011
1100000000000100000000000000000000000000000000000000000000000000000000000000011
1100000000000010000000000000000000000000000000000000000000000000000000000000011
1100000000000001000000000000000000000000000000000000000000000000000000000000011
1100000000000000100000000000000000000000000000000000000010000000000000000000011
1100000000000000010000000000000000000000000000010000000010000000000000000000011
1100000000000000001000000000000000000000000000010000000010000000000000000000011
1100000000000000000100000000000000000000000000010000000010000000000000000000011
1111111111111111111111111111111111111111111111111111111111111111111111111111111
1111111111111111111111111111111111111111111111111111111111111111111111111111111